########
#____#_E
#_#__#_#
#_#_##_#
S_#____#
########